#################################################
#...............................................#
#...............................................#
#...............................................#
#...............................................#
#...............................................#
#...............................................#
#...............................................#
#...............................................#
#...............................................#
#...............................................#
#...............................................#
#...............................................#
#...............................................#
#...............................................#
#...............................................#
#...............................................#
#...............................................#
#...............................................#
#...............................................#
#...............................................#
#...............................................#
#...............................................#
#...............................................#
#...............................................#
#...............................................#
#...............................................#
#...............................................#
#...............................................#
#...............................................#
#...............................................#
#...............................................#
#...............................................#
#...............................................#
#...............................................#
#...............................................#
#...............................................#
#####################...........................#
#...................#...........................#
#.#################.#############################
#.#.......#.........#........#.....#.....#......#
#.#.#####.#.#######.#.....#..#..#..#..#..#..#...#
#.#.....#.#.#..T....#.....#.....#.....#.....#...#
#.#.....#.#.#.....#.#.##.######################.#
#.#..T..#.#.#.....#.#.#...#...............#.....#
#.#######.#.#.....#.#.#.T.#.###############.T...#
#.#.......#.#.....#.#.#...#.#.............#.....#
#.#.#################.#####.#####################
#...............................................#
#################################################
